{
	"1" : "11",
	"2" : "13",
	"3" : "15",
	"4" : "29",
	"5" : "31",
	"6" : "33",
	"7" : "35",
	"8" : "37"
}